1 1 1 1 1 1 1 1 1 1 1 1 1 1 1 1 1 1 1 1  
1 _ _ _ G _ _ _ _ _ _ _ _ _ _ _ _ _ _ 1
1 _ 1 1 1 1 1 1 _ _ _ _ _ _ _ _ _ _ _ 1
1 _ _ _ _ _ 1 1 _ 1 _ _ _ _ _ _ _ _ _ 1
1 _ 1 _ 1 _ _ _ _ 1 _ _ _ 1 _ _ _ _ _ 1
1 _ _ _ 1 1 1 1 _ 1 _ _ _ 1 _ _ _ _ _ 1
1 1 1 _ 1 _ _ _ _ _ _ _ _ _ _ _ _ _ _ 1
1 _ P 1 1 1 1 _ _ 1 _ _ _ _ _ 1_ _ _ _1
1 _ _ _ _ _ 1 _ _ 1 _ _ 1 _ _ _ _ _ _ 1
1 1 1 1 _ _ 1 _ _ _ _ _ _ _ 1 1 1 1 1 1
1 _ _ _ _ _ 1 _ _ _ _ _ _ _ _ _ _ _ _ 1
1 _ _ _ _ _ 1 _ 1 1 1 1 1 1 1 _ 1 1 _ 1
1 _ _ 1 1 1 1 _ 1 _ _ 1 _ 1 _ _ 1 _ _ 1
1 _ _ _ 1 _ _ _ 1 _ _ _ _ _ _ _ 1 _ _ 1
1 _ _ _ 1 1 1 _ 1 _ _ 1 1 1 1 1 1 1 _ 1
1 _ _ _ 1 _ _ _ _ _ _ _ _ 1 _ _ 1 _ _ 1
1 _ _ _ 1 1 1 _ 1 1 1 1 _ 1 _ _ _ _ _ 1
1 _ _ _ _ _ _ _ _ _ _ _ _ _ _ _ 1 1 1 1
1 1 1 1 1 1 1 1 1 1 1 1 1 1 1 1 1 1 1 1 