1 1 1 1 1 1 1 1 1 1
1 G _ _ _ _ _ _ _ 1
1 _ 1 1 1 _ 1 _ _ 1
1 _ 1 _ _ _ 1 1 1 1
1 _ 1 _ 1 _ _ _ _ 1
1 _ _ _ 1 _ _ _ _ 1
1 _ 1 _ _ _ 1 _ _ 1
1 _ _ _ 1 _ 1 _ _ 1
1 _ _ _ _ _ 1 P _ 1
1 1 1 1 1 1 1 1 1 1